1,0,1,0,1,0,1
1,1,1,0,1,1,1
1,1,2,1,2,1,1
2,2,1,3,1,2,2
1,1,8,8,8,1,1
1,1,1,0,1,1,1
1,0,1,0,1,0,1
