5,4,2,1,2,4,5
4,3,1,0,1,3,4
3,2,0,0,0,2,3
2,1,0,0,0,1,2
1,0,0,0,0,0,1
