2,2,2,2,2,2,2
2,0,0,0,0,0,2
2,0,1,4,1,0,2
2,0,4,1,4,0,2
2,0,0,0,0,0,2
2,2,2,2,2,2,2
